13 13 13 13 13 13 13 13 13 13 13 13 13 13 13 13 13 13 13 13 13 13 13 13 13 13 13 13 13 13 13 13 13 13 13 13 13 13 13 13 13 13 13 13 13 13 13 13 13 13 
13 13 13 13 13 13 13 13 13 13 13 13 13 13 13 13 13 13 13 13 13 13 13 13 13 13 13 13 13 13 13 13 13 13 13 13 13 13 13 13 13 13 13 13 13 13 13 13 13 13 
13 13 13 13 13 13 13 13 13 13 13 13 13 13 13 13 13 13 13 13 13 13 13 13 13 13 13 13 13 13 13 13 13 13 13 13 13 13 13 13 13 13 13 13 13 13 13 13 13 13 
13 13 13 13 13 13 13 13 13 13 13 13 13 13 13 13 13 13 13 13 13 13 13 13 13 13 13 13 13 13 13 13 13 13 13 13 13 13 13 13 13 13 13 13 13 13 13 13 13 13 
13 13 13 13 13 13 13 13 13 13 13 13 13 13 13 13 13 13 13 13 13 13 13 13 13 13 13 13 13 13 13 13 13 13 13 13 13 13 13 13 13 13 13 13 13 13 13 13 13 13 
13 13 13 13 13 13 13 13 13 13 13 13 13 13 13 13 13 13 13 13 13 13 13 13 13 13 13 13 13 13 13 13 13 13 13 13 13 3 3 3 3 3 3 13 13 13 13 13 13 13 
13 13 13 13 13 13 13 13 13 13 13 13 13 13 13 13 13 13 13 13 13 13 13 13 3 3 13 13 13 13 13 13 13 13 13 13 13 3 3 3 3 3 3 13 13 13 13 13 13 13 
13 13 13 13 3 3 3 13 13 13 13 13 13 13 13 13 13 13 13 13 13 3 3 3 3 3 13 13 13 13 13 13 13 13 13 13 3 3 3 13 13 13 13 13 13 13 13 13 13 13 
13 13 13 13 3 3 3 13 13 13 13 13 13 13 13 13 13 13 3 3 3 3 3 3 3 3 13 13 13 13 13 13 13 13 13 13 3 3 13 13 13 13 13 13 13 13 13 13 13 13 
13 13 13 13 13 3 3 13 13 13 13 13 13 13 13 13 13 3 3 3 3 13 13 13 13 13 13 13 13 13 13 13 13 13 13 3 3 3 13 13 13 13 13 13 13 13 13 13 13 13 
13 13 13 13 13 13 3 13 13 13 13 13 13 13 13 13 3 3 3 13 13 13 13 13 13 13 13 13 13 13 13 13 13 13 13 3 3 3 13 13 13 13 13 13 13 13 13 13 13 13 
13 13 13 13 13 13 3 3 13 13 13 13 13 13 13 13 3 13 13 13 13 13 13 13 13 13 13 13 13 13 13 13 13 13 3 3 3 13 13 13 13 13 13 13 13 13 13 13 13 13 
13 13 13 13 13 13 3 3 13 13 13 13 13 13 13 13 3 13 13 13 13 13 13 13 13 13 13 13 13 13 13 13 13 13 3 3 3 13 13 13 13 13 13 13 13 13 13 13 13 13 
13 13 13 13 13 13 3 3 13 13 13 13 13 13 13 13 3 3 13 13 13 13 13 13 13 13 13 13 13 13 13 13 13 13 3 3 3 13 13 13 13 13 13 13 13 13 13 13 13 13 
13 13 13 13 13 13 3 3 13 13 13 13 13 13 3 3 3 3 13 13 13 13 13 13 13 13 13 13 13 13 13 13 13 13 3 3 3 13 13 13 13 13 13 13 13 13 13 13 13 13 
13 13 13 13 13 13 3 3 13 13 13 13 13 13 3 3 3 3 13 13 13 13 13 3 3 3 3 3 13 13 13 3 13 13 3 3 3 13 13 3 5 5 6 6 6 3 13 13 13 13 
13 13 13 13 13 3 6 6 6 6 6 13 13 13 6 6 6 6 6 6 13 13 3 3 3 3 3 3 13 3 3 3 3 13 13 3 3 13 3 3 0 0 0 0 0 10 13 13 13 13 
13 13 13 13 13 8 0 0 0 0 0 6 6 6 0 0 0 0 0 0 6 6 5 6 6 6 6 5 5 6 6 6 6 5 5 6 5 6 5 0 0 0 0 0 0 10 13 13 13 13 
13 13 13 13 13 8 0 0 1 0 0 1 0 0 0 3 0 0 1 0 0 0 0 0 0 0 0 0 0 1 0 0 0 0 0 0 0 0 0 0 0 0 0 0 0 10 13 13 13 13 
13 13 13 13 13 8 0 1 0 0 0 0 1 0 3 13 8 0 0 0 1 0 0 1 0 0 1 0 0 0 9 9 9 9 9 9 9 9 9 9 0 0 0 9 9 13 13 13 13 13 
13 13 13 13 3 8 0 0 0 0 0 0 0 1 0 0 0 0 0 0 0 0 0 1 0 0 0 0 0 10 3 3 3 3 3 13 13 13 3 3 8 0 10 13 13 13 13 13 13 13 
13 13 13 13 3 3 9 9 9 9 9 9 9 9 9 9 9 9 9 9 9 9 9 9 9 9 0 0 0 10 3 13 13 13 13 13 13 13 13 3 8 0 10 13 13 13 13 13 13 13 
13 13 13 13 13 13 13 13 13 13 13 13 13 13 13 13 13 13 13 13 13 13 13 3 3 3 8 1 0 10 3 13 13 13 13 13 13 13 13 3 8 0 10 3 13 13 13 13 13 13 
13 13 13 13 13 13 13 13 13 13 13 13 13 13 13 13 13 13 13 13 13 13 13 13 3 3 8 0 1 10 13 13 13 13 13 13 13 13 13 8 0 0 0 10 13 13 13 13 13 13 
13 13 13 13 13 13 13 13 13 13 13 13 13 13 13 13 13 13 13 13 13 13 13 13 3 3 8 0 1 10 13 13 13 13 13 13 13 13 13 3 8 0 0 10 13 13 13 13 13 13 
13 13 13 13 13 13 13 13 13 13 13 13 13 13 13 13 13 13 13 13 13 13 13 13 13 13 8 0 0 10 13 13 13 13 13 13 13 13 13 13 8 0 0 0 5 5 3 13 13 13 
13 13 13 13 13 13 13 13 13 13 13 13 13 13 13 13 13 13 13 13 13 13 13 13 13 13 8 1 0 10 3 13 13 13 13 13 13 13 13 13 8 0 0 0 0 0 3 13 13 13 
13 13 13 13 13 13 13 13 13 13 13 13 13 13 13 13 13 13 13 13 13 13 13 13 13 13 8 0 0 10 3 13 13 13 13 13 13 13 13 13 8 0 0 0 0 0 13 13 13 13 
13 13 13 13 13 13 13 13 13 13 13 13 13 13 13 13 13 13 13 13 13 13 13 13 13 13 8 0 1 10 3 13 13 13 13 13 13 13 13 13 3 9 9 9 9 9 13 13 13 13 
13 13 13 13 13 13 13 13 13 13 13 13 13 13 13 13 13 13 13 13 13 13 13 13 3 3 8 0 0 10 3 13 13 13 13 13 13 13 13 13 13 13 3 3 3 13 13 13 13 13 
13 13 13 13 13 13 13 5 5 5 13 13 13 13 13 13 13 13 13 13 13 13 13 13 3 3 8 1 0 10 3 13 13 13 13 13 13 13 13 13 13 13 3 3 13 13 13 13 13 13 
13 13 13 13 13 13 5 0 0 0 5 5 5 13 13 13 3 3 3 3 3 3 6 6 5 5 0 0 0 10 3 13 13 13 13 13 13 13 13 13 13 13 3 3 13 13 13 13 13 13 
13 13 13 13 13 8 0 0 0 0 0 0 0 6 6 5 5 6 6 5 6 6 0 0 0 0 0 0 0 10 13 13 13 13 13 13 13 13 13 13 13 13 3 3 13 13 13 13 13 13 
13 13 13 13 13 8 0 0 0 1 0 0 0 0 0 0 0 0 0 0 0 0 0 0 0 0 0 0 0 10 13 13 13 13 13 13 13 13 13 13 13 13 13 3 3 13 13 13 13 13 
13 13 13 13 13 8 0 1 0 0 0 0 0 0 0 0 0 0 9 9 9 9 9 9 9 9 0 0 0 10 13 13 13 13 13 13 13 13 13 13 13 13 13 3 13 13 13 13 13 13 
13 13 13 13 13 8 0 0 0 0 9 9 9 9 9 9 9 9 13 13 13 13 13 13 13 3 8 0 0 10 3 3 13 13 13 13 13 13 13 13 13 13 13 3 3 3 3 13 13 13 
13 13 13 13 13 8 0 0 0 10 13 13 13 13 13 13 13 13 13 13 13 13 13 13 13 13 8 0 0 10 3 3 3 13 13 13 13 13 13 13 13 13 3 3 3 3 3 13 13 13 
13 13 13 13 13 13 9 9 9 3 13 13 13 13 13 13 13 13 13 13 13 13 13 13 3 3 8 0 0 10 3 3 13 13 13 13 13 13 13 13 13 13 3 3 3 3 3 13 13 13 
13 13 13 13 13 13 3 3 3 3 13 13 13 13 13 13 13 13 13 13 13 13 13 3 3 3 8 0 1 10 3 13 13 13 13 13 13 13 13 13 3 6 6 3 13 3 3 13 13 13 
13 13 13 13 13 13 13 3 3 3 13 13 13 13 13 13 13 13 13 13 13 13 13 3 3 3 8 0 0 10 3 13 13 13 13 13 13 13 13 13 8 0 0 10 13 13 13 13 13 13 
13 13 13 13 13 13 13 13 3 3 3 3 13 13 13 13 13 13 13 13 13 13 13 3 3 3 8 0 0 10 3 13 13 13 13 13 13 13 13 13 8 0 0 10 13 13 13 13 13 13 
13 13 13 13 13 13 13 13 3 3 3 13 13 13 13 13 13 13 13 13 13 13 13 13 13 3 8 1 0 10 3 3 13 13 13 13 13 13 13 13 8 0 0 10 13 13 13 13 13 13 
13 13 13 13 13 13 13 13 13 13 13 13 13 13 13 13 13 13 13 13 13 13 13 13 13 8 0 0 0 10 13 13 13 13 13 13 13 13 13 13 8 0 0 10 13 13 13 13 13 13 
13 13 13 13 13 13 13 13 13 13 13 13 13 13 13 13 13 13 13 13 13 13 13 13 13 8 0 0 0 10 13 13 13 13 13 13 13 13 13 13 8 0 0 10 13 13 13 13 13 13 
13 13 13 13 13 13 13 13 13 13 13 13 13 13 13 13 13 13 13 13 13 13 13 13 13 3 13 13 13 13 13 13 13 13 13 13 13 13 13 13 8 0 0 0 10 13 13 13 13 13 
13 13 13 13 13 13 13 13 13 13 13 13 13 13 13 13 13 13 13 13 13 13 13 13 13 13 13 13 13 13 13 13 13 13 13 13 13 13 13 13 8 0 0 0 10 13 13 13 13 13 
13 13 13 13 13 13 13 13 13 13 13 13 13 13 13 13 13 13 13 13 13 13 13 13 13 13 13 13 13 13 13 13 13 13 13 13 13 13 13 13 13 9 9 9 13 13 13 13 13 13 
13 13 13 13 13 13 13 13 13 13 13 13 13 13 13 13 13 13 13 13 13 13 13 13 13 13 13 13 13 13 13 13 13 13 13 13 13 13 13 13 13 13 13 13 13 13 13 13 13 13 
13 13 13 13 13 13 13 13 13 13 13 13 13 13 13 13 13 13 13 13 13 13 13 13 13 13 13 13 13 13 13 13 13 13 13 13 13 13 13 13 13 13 13 13 13 13 13 13 13 13 
13 13 13 13 13 13 13 13 13 13 13 13 13 13 13 13 13 13 13 13 13 13 13 13 13 13 13 13 13 13 13 13 13 13 13 13 13 13 13 13 13 13 13 13 13 13 13 13 13 13 
