10 10 10 10 10 10 10 10 10 10 10 10 10 10 10 10 10 10 10 10 10 10 10 10 10 10 10 10 10 10 10 10 10 10 10 10 10 10 10 10 10 10 10 10 10 10 10 10 10 10 
10 10 10 10 10 10 10 10 10 10 10 10 10 10 10 10 10 10 10 10 10 10 10 10 10 10 10 10 10 10 10 10 10 10 10 10 10 10 10 10 10 10 10 10 10 10 10 10 10 10 
10 10 10 10 10 10 10 10 10 10 10 10 10 10 10 10 10 10 10 10 10 10 10 10 10 10 10 10 10 10 10 10 10 10 10 10 10 10 10 10 10 10 10 10 10 10 10 10 10 10 
10 10 10 10 10 10 10 10 10 10 10 10 10 10 10 10 10 10 10 10 10 10 10 10 10 10 10 10 10 10 10 10 10 10 10 10 10 10 10 10 10 10 10 10 10 10 10 10 10 10 
10 10 10 10 10 10 10 10 10 10 10 10 10 10 10 10 10 10 10 10 10 10 10 10 10 10 10 10 10 10 10 10 10 10 10 10 10 10 10 10 10 10 10 10 10 10 10 10 10 10 
10 10 10 10 10 10 10 10 10 10 10 10 10 10 10 10 10 10 10 10 10 10 10 10 10 10 10 10 10 10 10 10 10 10 10 10 10 2 2 2 2 3 3 10 10 10 10 10 10 10 
10 10 10 10 10 10 10 10 10 10 10 10 10 10 10 10 10 10 10 10 10 10 10 10 3 3 10 10 10 10 10 10 10 10 10 10 10 2 2 2 2 2 3 10 10 10 10 10 10 10 
10 10 10 10 3 3 2 10 10 10 10 10 10 10 10 10 10 10 10 10 10 2 2 2 2 3 10 10 10 10 10 10 10 10 10 10 2 2 2 10 10 10 10 10 10 10 10 10 10 10 
10 10 10 10 3 2 2 10 10 10 10 10 10 10 10 10 10 10 2 2 2 2 2 2 2 2 10 10 10 10 10 10 10 10 10 10 2 2 10 10 10 10 10 10 10 10 10 10 10 10 
10 10 10 10 10 2 2 10 10 10 10 10 10 10 10 10 10 2 2 2 2 10 10 10 10 10 10 10 10 10 10 10 10 10 10 2 3 2 10 10 10 10 10 10 10 10 10 10 10 10 
10 10 10 10 10 10 2 10 10 10 10 10 10 10 10 10 2 2 2 10 10 10 10 10 10 10 10 10 10 10 10 10 10 10 10 2 2 2 10 10 10 10 10 10 10 10 10 10 10 10 
10 10 10 10 10 10 2 2 10 10 10 10 10 10 10 10 3 2 10 10 10 10 10 10 10 10 10 10 10 10 10 10 10 10 10 2 2 2 10 10 10 10 10 10 10 10 10 10 10 10 
10 10 10 10 10 10 2 3 10 10 10 10 10 10 10 10 2 2 10 10 10 10 10 10 10 10 10 10 10 10 10 10 10 10 10 2 2 10 10 10 10 10 10 10 10 10 10 10 10 10 
10 10 10 10 10 10 2 2 10 10 10 10 10 10 10 10 2 2 10 10 10 10 10 10 10 10 10 10 10 10 10 10 10 10 10 2 2 10 10 10 10 10 10 10 10 10 10 10 10 10 
10 10 10 10 10 10 2 2 10 10 10 10 10 10 2 2 2 2 10 10 10 10 10 10 10 10 10 10 10 10 10 10 10 10 10 3 2 10 10 10 10 10 10 10 10 10 10 10 10 10 
10 10 10 10 10 10 2 2 10 10 10 10 10 10 2 2 2 2 10 10 10 10 10 2 3 2 2 10 10 10 10 2 10 10 10 2 2 10 10 2 5 5 5 5 5 10 10 10 10 10 
10 10 10 10 10 2 4 4 5 5 2 10 10 2 5 5 4 5 5 5 10 10 3 2 2 3 2 2 10 2 2 2 2 10 10 2 2 10 2 7 0 0 0 0 0 9 10 10 10 10 
10 10 10 10 10 7 0 0 0 0 5 5 5 5 0 0 0 0 0 0 5 5 5 5 5 5 5 5 5 5 5 5 5 5 5 5 5 5 5 0 0 0 0 0 0 9 10 10 10 10 
10 10 10 10 10 7 0 0 1 0 0 1 0 0 0 8 0 0 1 0 0 0 0 0 0 0 0 0 0 1 0 0 0 0 0 0 0 0 0 0 0 0 0 0 0 9 10 10 10 10 
10 10 10 10 10 7 0 1 0 0 0 0 1 0 3 10 7 0 0 0 1 0 0 1 0 0 1 0 0 0 8 8 8 8 8 8 8 8 8 8 0 0 0 8 8 10 10 10 10 10 
10 10 10 10 2 7 0 0 0 0 0 0 0 1 0 0 0 0 0 0 0 0 0 1 0 0 0 0 0 9 2 2 2 2 2 10 10 10 2 2 7 0 9 10 10 10 10 10 10 10 
10 10 10 10 3 2 8 8 8 8 8 8 8 8 8 8 8 8 8 8 8 8 8 8 8 8 0 0 0 9 2 10 10 10 10 10 10 10 10 3 7 0 9 10 10 10 10 10 10 10 
10 10 10 10 10 10 10 10 10 10 10 10 10 10 10 10 10 10 10 10 10 10 10 2 2 2 7 1 0 9 2 10 10 10 10 10 10 10 10 10 7 0 9 10 10 10 10 10 10 10 
10 10 10 10 10 10 10 10 10 10 10 10 10 10 10 10 10 10 10 10 10 10 10 10 2 2 7 0 1 9 10 10 10 10 10 10 10 10 10 10 7 0 0 9 2 10 10 10 10 10 
10 10 10 10 10 10 10 10 10 10 10 10 10 10 10 10 10 10 10 10 10 10 10 10 2 2 7 0 1 9 10 10 10 10 10 10 10 10 10 10 7 0 0 9 2 10 10 10 10 10 
10 10 10 10 10 10 10 10 10 10 10 10 10 10 10 10 10 10 10 10 10 10 10 10 10 10 7 0 0 9 10 10 10 10 10 10 10 10 10 10 7 0 0 0 5 5 2 10 10 10 
10 10 10 10 10 10 10 10 10 10 10 10 10 10 10 10 10 10 10 10 10 10 10 10 10 10 7 1 0 9 2 10 10 10 10 10 10 10 10 10 7 0 0 0 0 0 9 10 10 10 
10 10 10 10 10 10 10 10 10 10 10 10 10 10 10 10 10 10 10 10 10 10 10 10 10 10 7 0 0 9 2 10 10 10 10 10 10 10 10 10 7 0 0 0 0 0 9 10 10 10 
10 10 10 10 10 10 10 10 10 10 10 10 10 10 10 10 10 10 10 10 10 10 10 10 10 10 7 0 1 9 2 10 10 10 10 10 10 10 10 10 2 8 8 8 8 8 10 10 10 10 
10 10 10 10 10 10 10 10 10 10 10 10 10 10 10 10 10 10 10 10 10 10 10 10 2 2 7 0 0 9 2 10 10 10 10 10 10 10 10 10 10 10 3 2 2 10 10 10 10 10 
10 10 10 10 10 10 10 5 5 5 10 10 10 10 10 10 10 10 10 10 10 10 10 10 2 2 7 1 0 9 2 10 10 10 10 10 10 10 10 10 10 10 2 2 10 10 10 10 10 10 
10 10 10 10 10 10 5 0 0 0 5 5 5 10 10 10 10 10 10 10 2 2 2 2 5 5 0 0 0 9 2 10 10 10 10 10 10 10 10 10 10 10 2 2 10 10 10 10 10 10 
10 10 10 10 10 7 0 0 0 0 0 0 0 10 10 5 5 5 5 5 5 5 5 5 0 0 0 0 0 9 10 10 10 10 10 10 10 10 10 10 10 10 2 2 10 10 10 10 10 10 
10 10 10 10 10 7 0 0 0 1 0 0 0 0 0 0 0 0 0 0 0 0 0 0 0 0 0 0 0 9 10 10 10 10 10 10 10 10 10 10 10 10 10 2 2 10 10 10 10 10 
10 10 10 10 10 7 0 1 0 0 8 8 8 8 8 8 8 8 8 8 8 8 8 8 8 8 0 0 0 9 10 10 10 10 10 10 10 10 10 10 10 10 10 3 10 10 10 10 10 10 
10 10 10 10 10 7 0 0 0 9 10 10 10 10 10 2 10 10 2 2 2 10 10 10 10 10 7 0 0 9 2 2 10 10 10 10 10 10 10 10 10 10 10 2 2 2 2 10 10 10 
10 10 10 10 10 10 7 0 0 9 10 10 10 10 10 10 10 10 2 2 10 10 10 10 10 10 7 0 0 9 2 2 2 10 10 10 10 10 10 10 10 10 2 2 2 10 2 10 10 10 
10 10 10 10 10 10 2 8 8 2 10 10 10 10 10 10 10 10 10 10 10 10 10 10 3 2 7 0 0 9 2 2 10 10 10 10 10 10 10 10 10 10 2 2 2 2 2 3 10 10 
10 10 10 10 10 10 2 3 2 2 10 10 10 10 10 10 10 10 10 10 10 10 10 2 2 2 7 0 1 9 2 10 10 10 10 10 10 10 10 10 2 5 5 2 10 2 3 3 10 10 
10 10 10 10 10 10 10 2 2 2 2 10 10 10 10 10 10 10 10 10 10 10 10 3 2 2 7 0 0 9 2 10 10 10 10 10 10 10 10 10 7 0 0 9 10 10 10 10 10 10 
10 10 10 10 10 10 10 10 2 2 2 2 10 10 10 10 10 10 10 10 10 10 10 2 2 2 7 0 0 9 2 10 10 10 10 10 10 10 10 10 7 0 0 9 10 10 10 10 10 10 
10 10 10 10 10 10 10 10 2 2 2 10 10 10 10 10 10 10 10 10 10 10 10 10 10 2 7 1 0 9 2 2 10 10 10 10 10 10 10 10 7 0 0 9 10 10 10 10 10 10 
10 10 10 10 10 10 10 10 10 3 10 10 10 10 10 10 10 10 10 10 10 10 10 10 10 7 0 0 0 9 10 10 10 10 10 10 10 10 10 10 7 0 0 9 2 10 10 10 10 10 
10 10 10 10 10 10 10 10 10 10 10 10 10 10 10 10 10 10 10 10 10 10 10 10 10 7 0 0 0 9 10 10 10 10 10 10 10 10 10 10 10 0 0 0 9 10 10 10 10 10 
10 10 10 10 10 10 10 10 10 10 10 10 10 10 10 10 10 10 10 10 10 10 10 10 10 2 8 8 8 10 10 10 10 10 10 10 10 10 10 10 10 2 3 0 9 10 10 10 10 10 
10 10 10 10 10 10 10 10 2 10 10 10 10 10 10 10 10 10 10 10 10 10 10 10 10 10 3 3 10 10 10 10 10 10 10 10 10 10 10 10 10 7 0 0 9 10 10 10 10 10 
10 10 10 10 10 10 10 10 10 10 10 10 10 10 10 10 10 10 10 10 10 10 10 10 10 10 10 10 10 10 10 10 10 10 10 10 10 10 10 10 10 10 8 8 10 10 10 10 10 10 
10 10 10 10 10 10 10 10 10 10 10 10 10 10 10 10 10 10 10 10 10 10 10 10 10 10 10 10 10 10 10 10 10 10 10 10 10 10 10 10 10 10 10 10 10 10 10 10 10 10 
10 10 10 10 10 10 10 10 10 10 10 10 10 10 10 10 10 10 10 10 10 10 10 10 10 10 10 10 10 10 10 10 10 10 10 10 10 10 10 10 10 10 10 10 10 10 10 10 10 10 
10 10 10 10 10 10 10 10 10 10 10 10 10 10 10 10 10 10 10 10 10 10 10 10 10 10 10 10 10 10 10 10 10 10 10 10 10 10 10 10 10 10 10 10 10 10 10 10 10 10 
